backbone (n) — 1) основа, опора, суть; 2) магистраль
capability (n) — 1) возможность, способность; 2) производительность; 3) характеристика
concise (a) — краткий; сжатый; недолговременный
deploy (v) — вводить в действие, разворачивать
discard (information) (v) — отбрасывать, отвергать (напр., данные); не учитывать (напр., весь принимаемый кадр информации или его часть)
disposal (n) — освобождение
drastic (a) — 1) глубокий; 2) крутой; 3) форсированный
facilitate (v) — облегчать, способствовать, помогать, продвигать
inclined (a) — расположенный, предрасположенный, склонный
mainstay (n) — главная поддержка, опора, оплот
omission (n) — опускание; вычеркивание
shredder (n) — шредер, машинка для уничтожения бумаг
unify (v) — унифицировать; выполнять операцию унификации
airfare (n) — стоимость авиаперелета, цена авиабилета
attendee (n) — участник (конференции, семинара)
clock up (v) — 1) отмечать пройденное расстояние; 2) записывать в актив, в число достижений
dip (sb's toe) (v) — макать, окунать (чей-то палец ноги)
downturn (n) — спад (деловой активности); понижение, уменьшение
eliminate (v) — устранять, исключать
evangelical (a) — евангелический (относящийся к Евангелическо-лютеранской церкви)
flock (v) — стекаться; приходить толпой, собираться толпами
forge (v) — 1) постепенно выходить на первое место; 2) возглавлять, лидировать
implosion (n) — 1) уменьшение, сокращение; 2) обвал, фиаско (в политике, экономике)
plug (insurance) (v) — рекламировать (страхование)
recession (n) — рецессия, спад
standpoint (n) — позиция, точка зрения
tactile (a) — 1) осязательный, тактильный; 2) осязаемый, ощутимый
alongside (adv) — неподалеку, поблизости; около, возле, рядом
broadband (Internet) (a), (n) — 1) широкополосный; 2) широкополосная сеть; 3) технология, способная обеспечить одновременную передачу голоса, данных, видео; обычно это осуществляется путем мультиплексирования с разделением частот
chassis (n) — 1) шасси; 2) ходовая часть
erroneous (a) — ошибочный
prior to (adv) — 1) прежде чем; 2) до, перед, раньше
set-up (n) — структура, устройство (организации)
stock system (n) — система ассортимента (товаров)
terrestrial aerial (n) — наземная антенна
time-shift (v) — сдвигать во времени
vast (a) — обширный, огромный, широкий
weld (v) — сваривать, соединять
aptitude (n) — склонность, способность
chime (v) — соответствовать, звучать согласно
curriculum (n) — курс обучения, учебный план (в образовательном учреждении)
daunt (v) — пугать, обескураживать
debug (programs) (v) — отлаживать (программу)
disrepute (n) — дурная слава, плохая, сомнительная репутация
get to grips (v) — понимать, разбираться, справляться
groundswell (n) — волна, растущая общественная поддержка
overdo (v) — 1) перестараться, переусердствовать; 2) преувеличивать
pecking order (n) — неофициальная иерархия; сложившийся порядок подчинения
prosper (v) — благоденствовать, преуспевать, процветать
spark (v) — вызывать, становиться причиной
teething troubles (n) — первоначальные затруднения
unambiguous (a) — однозначный, недвусмысленный
clerical (a) — конторский, канцелярский
deem (v) — полагать, считать
drudgery (n) — тяжелая, монотонная работа
frumpy (a) — старомодный
grotty (a) — безобразный; никуда не годный
interminable (a) — бесконечный, беспредельный
keystroke (n) — нажатие клавиши или кнопки
paste (v) — вставлять (данные из буфера обмена в документ)
rewire (v) — перекоммутировать
skive (v) — увиливать, уклоняться (от работы); сачковать, прогуливать
subservient (a) — 1) подчиненный, зависимый; 2) рабский
surreptitious (a) — 1) тайный; сделанный тайком
tedium (n) — скука; утомительность
tot up (figures) — суммировать
valve (n) — (электронная) лампа
whir (v) — жужжать
whizzy (a) — продвинутый, на базе инновационных технологий
wizardry (n) — магия, волшебство
assign (v) — поручать
colon (n) — двоеточие
compliance (n) — согласие
data breach — повреждение, нарушение данных, информации
detect malware — замечать, обнаруживать вредоносное программное обеспечение (вирус)
disseminate (v) — распространять
encompass (v) — охватывать, включать
exceedingly (adv) — чрезвычайно, очень
influx (n) — наплыв, приток
juggle (v) — совмещать
layperson (n) — непрофессионал, дилетант
oversee (v) — наблюдать, контролировать
patch (v) — латать, ставить заплату
tangible (a) — реальный, ощутимый
be at stake — находиться под угрозой
vendor (n) — поставщик, производитель, продавец
vulnerability (n) — уязвимость, ранимость
accountability (n) — идентифицируемость, возможность идентификации
chunk (n) — 1) порция, проф. кусок программы; 2) участок памяти
cost-effective (a) — эффективный по затратам, рентабельный
cursory (a) — поверхностный, беглый
customized (a) — заказной, изготовленный по техническим условиям заказчика
deficiency (n) — нехватка, дефицит
detractor (n) — инсинуатор, клеветник, очернитель
enhance (v) — улучшать, доводить
exhaustively (adv) — исчерпывающе, полностью, совершенно
feasibility (n) — осуществимость, выполнимость
for awhile — на (какое-то) время, ненадолго
incrementally (adv) — поступательно, шаг за шагом
iterative (a) — итеративный, итерационный
linear (a) — линейный, прямолинейный
maintenance (n) — обслуживание, содержание
milestone (n) — 1) промежуточный этап разработки; 2) контрольная точка (хода проектирования)
nevertheless (adv) — тем не менее
novice (n) — начинающий, новичок
overlapping (a) — перекрывающий, частично дублирующий
pitfall (n) — возможная ошибка, сложность
post-mortem — вскрытие, обсуждение игры после ее окончания
proponent (n) — сторонник, защитник
rigid (a) — жесткий, негибкий
rigorously (adv) — тщательно
sequential (a) — последовательный (процесс)
sheer (a) — абсолютный, полнейший
sloppy (a) — нестабильный (об источнике питания)
thorough (a) — тщательный, доскональный
truism (n) — трюизм, прописная истина
turn-around (n) — неожиданное изменение, поворот (к более благоприятной ситуации)
viable (a) — жизнеспособный
amplitude (n) — амплитуда
antiquated — устарелый, архаичный, допотопный
array (n) — множество, спектр, матрица
asynchronous (adj) — асинхронный, несинхронный; несинхронизированный
brute force (v) — решать «в лоб» / методом грубой силы
byproduct (n) — побочный продукт/результат
carbon breakdown — распад/расщепление углерода
circuit (n) — цепь, электрическая цепь, схема, электросхема
compatibility (n) — совместимость, сочетаемость, сопоставимость
cutting-edge (adj) — передовой, современный, новейший
decay (v) — распадаться, разлагаться
decoherence (n) — декогеренция, распад суперпозиционных состояний
discreet (adj) — дискретный, прерывистый
emergent (adj) — новый, возникший, развивающийся
emission (n) — выброс, выделение теплоты
entanglement (n) — запутанность; затруднительное положение
equation (n) — уравнение, формула
excel at smth (v) — преуспеть в чём-л.; выполнять что-то особенно хорошо
factor (v) — разлагать на множители; факторизовать
fine-tuned — точно настроенный
harness (v) — использовать
high-fidelity measurement — высокоточное измерение
inaccessible (adj) — недоступный, недостижимый, труднодоступный
laborious (adj) — трудоемкий, трудный
maze (n) — лабиринт, дебри
mitigate (v) — смягчать; уменьшать, снижать, ослаблять
output (v) — выводить, производить, выпускать
petrochemical (adj) — нефтехимический
probabilistically (adv) — вероятностно
punch-card adders — сумматоры перфокарт
quantum dots — квантовые точки (КТ)
qubit (n) — кубит (= quantum bit) - наименьшая единица информации в квантовом компьютере (аналог бита в обычном компьютере), использующаяся для квантовых вычислений
ramp up (v) — набирать обороты, наращивать
scalability (n) — масштабируемость, расширяемость, универсальность
scale (v) — масштабировать; определять масштаб
semiconductor — полупроводник, полупроводниковый прибор
speedup (n) — ускорение; увеличение быстродействия; коэффициент ускорения
superconductor development — разработка сверхпроводников
accessibility (n) — доступность
actionable (adj) — действенный
adjustable (adj) — регулируемый
alert (v) — предупреждать об опасности
align with (v) — соответствовать
amenity (n) — удобства
assess (v) — оценивать
attainable (adj) — достижимый
bar code (n) — штрих-код
burglary (n) — кража со взломом, ограбление
buzzword (n) — модное словечко
capability (n) — способность, возможность, умение
come into picture (idiom) — выходить на сцену / на первый план
computation (n) — вычисление, действие или процесс вычисления ответа или суммы с помощью машины
consistent (adj) — согласованный, последовательный
consumption (n) — потребление
contribute to (v) — способствовать, быть причиной
crucial (adj) — решающий, ключевой
disability (n) — инвалидность, ограниченные возможности
enhance (v) — улучшать, совершенствовать
era (n) — эра, эпоха
evoke (v) — вызывать
facilitate (v) — способствовать, облегчать
font (n) — шрифт
frustration (n) — разочарование
gaze detection (n) — распознавание взгляда
handheld (adj) — портативный, переносной
headphones (n) — наушники
iteratively (adv) — итеративно, многократно, часто повторяемо
medium (n) — средство, метод общения
memorability (n) — запоминаемость
musculoskeletal disorder (n) — расстройство/нарушение опорно-двигательного аппарата
objective (n) — цель; что-то, что вы планируете сделать или достичь
pave the way (idiom) — проложить путь
posture (n) — поза, положение
refine (v) — совершенствовать, улучшать
retain (v) — сохранять, удерживать
strain (n) — напряжение, нагрузка
streamline (v) — оптимизировать
survey (n) — опрос
various (adj) — разный, различный
vehicle (n) — транспортное средство
abandonment (n) — отказ, оставление
artery (n) — артерия
behemoth (n) — гигант, бегемот
benchmark (n) — эталон, отметка высоты
biennially (adv) — каждые два года
bolster (v) — поддерживать
consecutive (adj) — последовательный
cutting-edge (adj) — передовой
deter (v) — сдерживать, удерживать
enticing (adj) — заманчивый, соблазнительный
excel in (v) — преуспеть в
exponentially (adv) — показательно
frontrunner (n) — лидер
governance (n) — управление, руководство
harness (v) — использовать
hit the market (v) — выйти на рынок
holistic (adj) — целостный
incentive (n) — стимул, побуждение
incentivization (n) — стимулирование
lag (v) — отставать
literacy (n) — грамотность
monetary transactions (n) — денежные операции
poise (v) — уравновешивать, балансировать
proliferation (n) — распространение
proponent (n) — сторонник
reaffirm position — подтвердить позицию
replicate (v) — повторять, копировать
retain (v) — сохранять, удерживать
rival (n) — соперник, конкурент
rural (adj) — деревенский, сельский
saddle smb with sth (v) — взваливать (на кого-л.) что-л.
seamlessly (adv) — бесшовно
shipping (n) — перевозка груза, доставка
shopping cart (n) — корзина
solely (adv) — исключительно, только
stride (n) — шаг, большой шаг
survey (n) — опрос, обзор
table (n) — планшет
tailor (v) — адаптировать, специально приспосабливать
testimonial (n) — рекомендации, отзывы
thread (n) — нить
upswing (n) — подъем, рост
weave/wove/woven (v) — плести, вплетать
advent (n) — появление, пришествие
ambient (adj) — окружающий, внешний
appropriate (v) — присваивать
bear false witness — давать ложные показания; лжесвидетельствовать
by any stretch (idiom) — (= by any stretch of imagination) как ни напрягай фантазию, при всём желании
clear-cut (adj) — чёткий, ясный, отчётливый
commandment (n) — заповедь, наказ, предписание
consideration (n) — уважение, предупредительность
constitute a theft — квалифицироваться как кража; является кражей
contested (part) — спорный, оспариваемый
disseminate (v) — распространять, рассеивать
eliminate bias — устранить предвзятость
embed (v) — встроить, интегрировать, внедрить
enforcement (n) — соблюдение, исполнение
fraud (n) — обман, мошенничество, подделка
impartiality (n) — беспристрастность, объективность
insure (v) — обеспечить
justifiable (adj) — оправданный, правомерный, законный, допустимый
opaque (adj) — непрозрачный, непроницаемый
overlap (with) (v) — совпадать, пересекаться
pertinent (adj) — соответствующий, уместный
pervasive (adj) — всепроникающий, повсеместно распространенный
prey (v) — обманывать, наживаться, грабить
proprietary (adj) — запатентованный, частный, личный, чужой
repercussion (n) — последствия, отголосок, отзвук
scam (n) — афера, мошенничество
snoop around (v sl.) — вынюхивать, выслеживать, шпионить, «рыться», совать нос в чужие дела
strive (v) — стараться, стремиться
surveillance (n) — наблюдение, слежение, контроль
tenet (n) — принцип, постулат
ubiquitous (adj) — вездесущий, повсеместный
vulnerable (adj) — уязвимый, незащищенный, беззащитный
alert (v) — предупреждать об опасности, поднимать по тревоге
assembly-line (n) — сборочная линия
bank teller (n) — кассир банка
bartender (n) — бармен
bowling pinsetter — установщик кеглей для боулинга
comb through (v) — просматривать
commonplace (adj) — обычное дело/явление
construction (n) — строительство
deploy (v) — развертывать, применять
disposal (n) — обезвреживание, утилизация
dozing (n) — работа бульдозером
draft (v) — составлять; набрасывать черновик
drive-thru — автокафе, ресторан или другое заведение, в котором можно обслужиться, не выходя из машины
endanger (v) — подвергать опасности
enticing (adj) — заманчивый
film projectionist — киномеханик
forklift machine — вилочный погрузчик, грузоподъемник
grocery store — продуктовый магазин
hauling (n) — транспортировка, перевозка
infantry (n) — пехота
jack (n) — гнездо
lawnmower (n) — газонокосилка
mining (n) — горнодобывающая промышленность
obsolete (adj) — устаревший, отживший
paralegal (n) — помощник юриста
reel (n) — катушка
shipment of goods — доставка товаров
stagger (v) — ошеломлять, потрясать, поражать
stockroom (n) — складское помещение, хранилище
switchboard operator — оператор коммутатора
troubleshooting (adj) — аварийный, поиск неисправностей
typist (n) — машинистка
warehousing (n) — складирование
weeds — сорняки, бурьян
withdraw (v) — изымать, забирать, брать назад
